9.3066449877697049e-02
1.0365169425542020e-01
1.0322194559132987e-01
9.6261167370172110e-02
1.0316027944301574e-01
1.0174219052754259e-01
1.0113272925964399e-01
1.0322375697146252e-01
1.0072485435965960e-01
1.0268596292588053e-01
1.0159920692384553e-01
1.0206208180539209e-01
9.8915807011373327e-02
1.0321600453926054e-01
7.7684012030743280e-02
1.0305544729474043e-01
8.3122651863098057e-02
8.5564468083341033e-02
1.0341854609692161e-01
1.0081679227288409e-01
9.4911635771215822e-02
1.0345660785449150e-01
8.4412377076604678e-02
9.8903736213992094e-02
1.0207765957863725e-01
9.5060715445390825e-02
9.6452506066692340e-02
7.8406049504777142e-02
8.4266563365291633e-02
9.4743886356459375e-02
1.0382316491947562e-01
1.0405072904512096e-01
1.0305579567541030e-01
1.0445951905244505e-01
8.9120702384030734e-02
1.0283499016700826e-01
1.0468068526325044e-01
1.0383237632614775e-01
1.0306420279883317e-01
7.9521762762846296e-02
1.0305696083302138e-01
1.0341980160862894e-01
1.0270583482857108e-01
9.9189475093319490e-02
1.0333828580087762e-01
9.7507614185092489e-02
9.9557864052209635e-02
8.2149151954884245e-02
1.0162187363156605e-01
1.0278938785840146e-01
7.2421643223756035e-02
1.0342326995340693e-01
1.0189318477354732e-01
9.3060812917098973e-02
8.7965905683853041e-02
9.9210184316050831e-02
1.0127473080442199e-01
1.0231460491496791e-01
7.5343238672086740e-02
1.0098623009350355e-01
4.6216477553938103e-02
1.0280901927791283e-01
1.0278938785840146e-01
1.0414308549059068e-01
6.7802809945285952e-02
1.0281326511478957e-01
1.0088722974099675e-01
1.0283428473886776e-01
1.0100342116887466e-01
9.2864722845291514e-02
9.2447731379273493e-02
1.0236663810676974e-01
9.5622621436574101e-02
9.6081423926788020e-02
8.5746298611162466e-02
1.0286567001001945e-01
1.0073012129866869e-01
1.0200574480168835e-01
1.0190713054079788e-01
8.2267275601412046e-02
1.0319114554534993e-01
1.0197830208899966e-01
1.0315798359075379e-01
6.8116246451516274e-02
1.0459435707596745e-01
1.0305806085182943e-01
8.5878381510852017e-02
1.0305579567541030e-01
1.0156842326065386e-01
1.0341138553944314e-01
9.2503740100694079e-02
1.0305579567541030e-01
9.2033898912734349e-02
1.0301075650372851e-01
9.6086047767217714e-02
1.0221301000973819e-01
1.0296443263923778e-01
1.0198604283618087e-01
1.0342671912289129e-01
7.5159248826068115e-02
